#######################
#.........#......#....#
#.........#......#....#
#.........#......#....#
#.........#......#....#
#.........#......#....#
#.........#......#....#
#.....................#
#.........#......#....#
#.........#......#....#
#.........#......#....#
#####.#####......#....#
#.........#......#....#
#.........#########...#
#................##...#
#.........#......##...#
#######################
